1111111111111111111111111
110E0100C0000000111C01CP1
1010000000110000001101101
10000000111000C0000000001
100000C01C000000000000001
1111111111111111111111111